SSSUUUUUUUOUUUUUOUUU
SSSUUUUUUUOUUUUUOUUU
SSSUUUUUUUOUUUUUOUUU
UUUUUUUUUUOOUUUOOUUU
UUUUUOUUUUUUUUUUUUUU
UUUUUOUUUUUUUUUUUUUU
UUUUUOUUUUUUUUUUUUUU
OUUUUOUUUUUUUUUOUUUO
OUUUUOUUUUUUUUOUUUUU
OUUUUOUUUUUUUOUUUUUU
UUUUUUUUUUOOOUUUUUUU
UUUUUUUUUUUUUUUUUUUU
UUUUUUUUUUUUUUUUUGGG
UUUUUUUUUUUUUUUUUGGG
UUUUUOOOUUUUUUOUUGGG