SSSUUUOUUUUUOUUUUUUU
SSSUUUOUUUUUOUUUUUUU
SSSUUUOOUUUUOOUUUUUU
UUUUUUUUUUUUUUUUUOOO
UUUUUUUUUUUUUUUUUOUU
UUUUUUUUUUUUUUUUUUUU
UUUUUUUUUOOOOUUUUUUU
UUUUUOUUUUUUOUUUUUUU
UUUUUOUUUUUUUUUUOUUU
UUUUUOUUUUUUUUUUOUUU
UUUUUUUUUUUUUUUUUUUU
UUUUUUUUUUOOUUUUUUUU
UUUOUUUUUUUOUUUUUGGG
UUUOUUUUUUUOUUUUUGGG
UUUOUUUUUUUOUUUUUGGG