EEEEEEEEEEEEEEEEEEUE
EEEEEEEEEEEEEEEEEEOE
EEEEEEEEEEEEEEEEEEEE
EEEEOEEEEOOOOOOEEEEE
EEEEOEEEEEEEEEEEEEEE
OEEEOEEEEEEEEEEEOEEE
OEEEEEEEEEEEEEEEEEEE
EEEEEEEEEEEEEEEEEEEE
EEEEEEEEEEEEEEEEEEEE
EEEEEEEEEEEEEEEOEEEO
EEEEEEEEEEEEEEEOEEEE
EEEEEOOOOOOEEEEOEEEE
EEEEEEEEEEEEEEEEEEEE
EOEEEEEEEEEEEEEEEEEE
EUEEEEEEEEEEEEEEEEEE