EEEEEEEOEEEEEEEEEEEE
EEEEEEEOEEEEEEEEEEEE
EEEEEEEOEEEEEEEEEEEE
EEEEEEEEEEEEEEEEEEEE
EEEEEEEEEEEOOEEEEEOE
EEEEEEEEEEEOOEEEEEEE
EEEEEEEEEEEUOEEEEEEE
EEEEEEEEEEEUOEEEOEEE
EEEOOOEEEEEUOEEEEEEE
EEEEEEEEEEEOOEEEEEEE
EEEEEEEEEEEEEEEEEEEE
EEEEEEEEEEEEEEEEEEEE
EEEEEEEEEEEEEEEEEEEE
EEEEEEEEEEEEEEOEEEEE
EEEEEEEEEEEEEEEEEEEE