EEEEEEEEEEEEEEEEEEEE
EEEEEEEEEEEEEEEEEEOE
EEEEEEEEEEEEEEEEEEEE
EEEEOEEEEOOOOOOEEEEE
EEEEOEEEEUUUEEEEEEEE
OEEEOEEEEUUUUUUEOEEE
OEEEEEEEEUUEEEEEEEEE
EEEEEEEEEUUEEEEEEEEE
EEEEEEEEEUUEEEEEEEEE
EEEEEEEEEUUEEEEOEEEO
EEEEEEEEUUUEEEEOEEEE
EEEEEOOOOOOEEEEOEEEE
EEEEEEEEEEEEEEEEEEEE
EOEEEEEEEEEEEEEEEEEE
EEEEEEEEEEEEEEEEEEEE