SSSUUUUUUOUUUUUOUUUU
SSSUUUUUUOUUUUUOUUUU
SSSUUUUUUOUUUUUOUUUU
UUUUUUUUUOOUUUOOUUUU
UUUUUOUUUUUUUUUUUUUU
UUUUOOUUUUUUUUUUUUUU
UUUUOOUUUUUUUUUUUUUU
UUUUOUUUUUUUUUUUUUUO
UUUUUUUUUUUUUUOOUUUU
UUUUUUUUUUUUUUOUUUUU
UUUUUUUUUUUUOOOUUUUU
UUUUUUUUUUUUUUUUUUUU
UUUUUUUUUUUUUUUUUGGG
UUUUGUUUUUUUUUUUUGGG
UUUUGGGGUUUUUOOUUGGG