SSSUUUUUUOOOUUUUUUUU
SSSUUUUUUUUOUUUUUUUU
SSSUUUUUUUUOUUUUUUUU
UUUUUOUUUUUOUUUOOUUU
UUUUUOUUUUUUUUUUUUUU
UUUUOOUUUUUUUUUUUUUU
UUUUUUUUUUUUUUUUUUUU
UUUUUUUUUUUUUUUUUOOO
UUUUUUUUUUUUUUUUUUUO
UUUUUUUUUUUUUUUUUUUU
OOOUUUUUUUUUOOUUUUUU
OOOUUUUUUUOOUUUUUUUU
UUUUUUOUUUUUUUUUUGGG
UUUUUUOUUUUUUUUUUGGG
UUUUUUOUUUUUUUUOUGGG